{
    "name": "emeralds_test",
    "width": 64,
    "height": 32,
    "pointsNeeded" : 2,
    "mapStructure" : {
        "charCount" : 2
    },
    "map":[
        "WsWsWsWsWsWsWsWsWsWsWsWsWsWsWsWsWsWsWsWsWsWsWsWsWsWsWsWsWsWsWsWsWsWsWsWsWsWsWsWsWsWsWsWsWsWsWsWsWsWsWsWsWsWsWsWsWsWsWsWsWsWsWsWs",
        "Ws$1$1$1$1$1$1$1$1$1$1$1$1$1$1$1$1$1$1$1$1$1$1$1$1$1$1$1$1$1$1$1$1$1$1$1$1$1$1$1$1$1$1$1$1$1$1$1$1$1$1$1$1$1$1$1$1$1$1$1$1$1$1Ws",
        "Ws$1$1$1$1$1$1$1$1$1$1$1$1$1$1$1$1$1$1$1$1$1$1$1$1$1$1$1$1$1$1$1$1$1$1$1$1$1$1$1$1$1$1$1$1$1$1$1$1$1$1$1$1$1$1$1$1$1$1$1$1$1$1Ws",
        "Ws$1$1$1$1$1$1$1$1$1$1$1$1$1$1$1$1$1$1$1$1$1$1$1$1$1$1$1$1$1$1$1$1$1$1$1$1$1$1$1$1$1$1$1$1$1$1$1$1$1$1$1$1$1$1$1$1$1$1$1$1$1$1Ws",
        "Ws$1$1$1$1$1$1$1$1$1$1$1$1$1$1$1$1$1$1$1$1$1$1$1$1$1$1$1$1$1$1$1$1$1$1$1$1$1$1$1$1$1$1$1$1$1$1$1$1$1$1$1$1$1$1$1$1$1$1$1$1$1$1Ws",
        "Ws$1$1$1$1$1$1$1$1$1$1$1$1$1$1$1$1$1$1$1$1$1$1$1$1$1$1$1$1$1$1$1$1$1$1$1$1$1$1$1$1$1$1$1$1$1$1$1$1$1$1$1$1$1$1$1$1$1$1$1$1$1$1Ws",
        "Ws$1$1$1$1$1$1$1$1$1$1$1$1$1$1$1$1$1$1$1$1$1$1$1$1$1$1$1$1$1$1$1$1$1$1$1$1$1$1$1$1$1$1$1$1$1$1$1$1$1$1$1$1$1$1$1$1$1$1$1$1$1$1Ws",
        "Ws$1$1$1$1$1$1$1$1$1$1$1$1$1$1$1$1$1$1$1$1$1$1$1$1$1$1$1$1$1$1$1$1$1$1$1$1$1$1$1$1$1$1$1$1$1$1$1$1$1$1$1$1$1$1$1$1$1$1$1$1$1$1Ws",
        "Ws$1$1$1$1$1$1$1$1$1$1$1$1$1$1$1$1$1$1$1$1$1$1$1$1$1$1$1$1$1$1$1$1$1$1$1$1$1$1$1$1$1$1$1$1$1$1$1$1$1$1$1$1$1$1$1$1$1$1$1$1$1$1Ws",
        "Ws$1$1$1$1$1$1$1$1$1$1$1$1$1$1$1$1$1$1$1$1$1$1$1$1$1$1$1$1$1$1$1$1$1$1$1$1$1$1$1$1$1$1$1$1$1$1$1$1$1$1$1$1$1$1$1$1$1$1$1$1$1$1Ws",
        "Ws$1$1$1$1$1$1$1$1$1$1$1$1$1$1$1$1$1$1$1$1$1$1$1$1$1$1$1$1$1$1$1$1$1$1$1$1$1$1$1$1$1$1$1$1$1$1$1$1$1$1$1$1$1$1$1$1$1$1$1$1$1$1Ws",
        "Ws$1$1$1$1$1$1$1$1$1$1$1$1$1$1$1$1$1$1$1$1$1$1$1$1$1$1$1$1$1$1$1$1$1$1$1$1$1$1$1$1$1$1$1$1$1$1$1$1$1$1$1$1$1$1$1$1$1$1$1$1$1$1Ws",
        "Ws$1$1$1$1$1$1$1$1$1$1$1$1$1$1$1$1$1$1$1$1$1$1$1$1$1$1$1$1$1$1$1$1$1$1$1$1$1$1$1$1$1$1$1$1$1$1$1$1$1$1$1$1$1$1$1$1$1$1$1$1$1$1Ws",
        "Ws$1$1$1$1$1$1$1$1$1$1$1$1$1$1$1$1$1$1$1$1$1$1$1$1$1$1$1$1$1$1$1$1$1$1$1$1$1$1$1$1$1$1$1$1$1$1$1$1$1$1$1$1$1$1$1$1$1$1$1$1$1$1Ws",
        "Ws$1$1$1$1$1$1$1$1$1$1$1$1$1$1$1$1$1$1$1$1$1$1$1$1$1$1$1$1$1$1$1$1$1$1$1$1$1$1$1$1$1$1$1$1$1$1$1$1$1$1$1$1$1$1$1$1$1$1$1$1$1$1Ws",
        "Ws$1$1$1$1$1$1$1$1$1$1$1$1$1$1$1$1$1$1$1$1$1$1$1$1$1$1$1$1$1$1$1P1$1$1$1$1$1$1$1$1$1$1$1$1$1$1$1$1$1$1$1$1$1$1$1$1$1$1$1$1$1$1Ws",
        "Ws$1$1$1$1$1$1$1$1$1$1$1$1$1$1$1$1$1$1$1$1$1$1$1$1$1$1$1$1$1$1$1$1$1$1$1$1$1$1$1$1$1$1$1$1$1$1$1$1$1$1$1$1$1$1$1$1$1$1$1$1$1$1Ws",
        "Ws$1$1$1$1$1$1$1$1$1$1$1$1$1$1$1$1$1$1$1$1$1$1$1$1$1$1$1$1$1$1$1$1$1$1$1$1$1$1$1$1$1$1$1$1$1$1$1$1$1$1$1$1$1$1$1$1$1$1$1$1$1$1Ws",
        "Ws$1$1$1$1$1$1$1$1$1$1$1$1$1$1$1$1$1$1$1$1$1$1$1$1$1$1$1$1$1$1$1$1$1$1$1$1$1$1$1$1$1$1$1$1$1$1$1$1$1$1$1$1$1$1$1$1$1$1$1$1$1$1Ws",
        "Ws$1$1$1$1$1$1$1$1$1$1$1$1$1$1$1$1$1$1$1$1$1$1$1$1$1$1$1$1$1$1$1$1$1$1$1$1$1$1$1$1$1$1$1$1$1$1$1$1$1$1$1$1$1$1$1$1$1$1$1$1$1$1Ws",
        "Ws$1$1$1$1$1$1$1$1$1$1$1$1$1$1$1$1$1$1$1$1$1$1$1$1$1$1$1$1$1$1$1$1$1$1$1$1$1$1$1$1$1$1$1$1$1$1$1$1$1$1$1$1$1$1$1$1$1$1$1$1$1$1Ws",
        "Ws$1$1$1$1$1$1$1$1$1$1$1$1$1$1$1$1$1$1$1$1$1$1$1$1$1$1$1$1$1$1$1$1$1$1$1$1$1$1$1$1$1$1$1$1$1$1$1$1$1$1$1$1$1$1$1$1$1$1$1$1$1$1Ws",
        "Ws$1$1$1$1$1$1$1$1$1$1$1$1$1$1$1$1$1$1$1$1$1$1$1$1$1$1$1$1$1$1$1$1$1$1$1$1$1$1$1$1$1$1$1$1$1$1$1$1$1$1$1$1$1$1$1$1$1$1$1$1$1$1Ws",
        "Ws$1$1$1$1$1$1$1$1$1$1$1$1$1$1$1$1$1$1$1$1$1$1$1$1$1$1$1$1$1$1$1$1$1$1$1$1$1$1$1$1$1$1$1$1$1$1$1$1$1$1$1$1$1$1$1$1$1$1$1$1$1$1Ws",
        "Ws$1$1$1$1$1$1$1$1$1$1$1$1$1$1$1$1$1$1$1$1$1$1$1$1$1$1$1$1$1$1$1$1$1$1$1$1$1$1$1$1$1$1$1$1$1$1$1$1$1$1$1$1$1$1$1$1$1$1$1$1$1$1Ws",
        "Ws$1$1$1$1$1$1$1$1$1$1$1$1$1$1$1$1$1$1$1$1$1$1$1$1$1$1$1$1$1$1$1$1$1$1$1$1$1$1$1$1$1$1$1$1$1$1$1$1$1$1$1$1$1$1$1$1$1$1$1$1$1$1Ws",
        "Ws$1$1$1$1$1$1$1$1$1$1$1$1$1$1$1$1$1$1$1$1$1$1$1$1$1$1$1$1$1$1$1$1$1$1$1$1$1$1$1$1$1$1$1$1$1$1$1$1$1$1$1$1$1$1$1$1$1$1$1$1$1$1Ws",
        "Ws$1$1$1$1$1$1$1$1$1$1$1$1$1$1$1$1$1$1$1$1$1$1$1$1$1$1$1$1$1$1$1$1$1$1$1$1$1$1$1$1$1$1$1$1$1$1$1$1$1$1$1$1$1$1$1$1$1$1$1$1$1$1Ws",
        "Ws$1$1$1$1$1$1$1$1$1$1$1$1$1$1$1$1$1$1$1$1$1$1$1$1$1$1$1$1$1$1$1$1$1$1$1$1$1$1$1$1$1$1$1$1$1$1$1$1$1$1$1$1$1$1$1$1$1$1$1$1$1$1Ws",
        "Ws$1$1$1$1$1$1$1$1$1$1$1$1$1$1$1$1$1$1$1$1$1$1$1$1$1$1$1$1$1$1$1$1$1$1$1$1$1$1$1$1$1$1$1$1$1$1$1$1$1$1$1$1$1$1$1$1$1$1$1$1$1$1Ws",
        "Ws$1$1$1$1$1$1$1$1$1$1$1$1$1$1$1$1$1$1$1$1$1$1$1$1$1$1$1$1$1$1$1$1$1$1$1$1$1$1$1$1$1$1$1$1$1$1$1$1$1$1$1$1$1$1$1$1$1$1$1$1$1$1Ws",
        "WsWsWsWsWsWsWsWsWsWsWsWsWsWsWsWsWsWsWsWsWsWsWsWsWsWsWsWsWsWsWsWsWsWsWsWsWsWsWsWsWsWsWsWsWsWsWsWsWsWsWsWsWsWsWsWsWsWsWsWsWsWsWsWs"
    ]
}