{
    "name" : "Emerald_Mine_1_0",
    "width" :64,
    "height" :32,
    "minimumScore" :10,
    "mapStructure" : {
        "charCount" : 2
    },
    "map" : [
        "WsWsWsWsWsWsWsWsWsWsWsWsWsWsWsWsWsWsWsWsWsWsWsWsWsWsWsWsWsWsWsWsWsWsWsWsWsWsWsWsWsWsWsWsWsWsWsWsWsWsWsWsWsWsWsWsWsWsWsWsWsWsWsWs",
        "Ws........WsWs................................WsWs............................WsWs......$1..........WsWs..................Ws..Ws",
        "Ws..........................$1..............WsWs..Ws........................Ws......Ws........WsWs......Ws..............Ws....Ws",
        "Ws............Ws........................Ws..........Ws................................WsWsWs..............Ws..........Ws......Ws",
        "Ws..............Ws....................WsWs............Ws..................Ws..........WsWs..................Ws....Ws..........Ws",
        "Ws....................WsWsWsWs....WsWs................Ws..................Ws..............Ws................Ws..WsWs..........Ws",
        "Ws................Ws............Ws................................WsWs....Ws............Ws................Ws....Ws............Ws",
        "Ws..............Ws................Ws..................Ws......Ws......WsWs................WsWs..........WsWs......Ws....$1....Ws",
        "Ws............Ws..................Ws..................Ws................Ws..............Ws......WsWs..Ws..WsWs......Ws........Ws",
        "Ws............Ws......................................WsWs............WsWsWs..........Ws..........WsWsWs..............Ws......Ws",
        "Ws..........Ws..........$1........Ws..............WsWs................WsWs..WsWsWsWsWsWs......................Ws........WsWs..Ws",
        "Ws....................................Ws..WsWsWsWs......................Ws..............Ws......WsWs............Ws........Ws..Ws",
        "Ws..........Ws....................WsWs..........Ws......................Ws......................................Ws..........WsWs",
        "Ws..........Ws..........................................................Ws........$1......Ws......Ws....$1......Ws........Ws..Ws",
        "WsWs..WsWs..Ws....................Ws..............Ws....................Ws..................Ws....Ws............Ws......WsWs..Ws",
        "Ws........WsWsWsWsWs............Ws................Ws..................Ws..Ws................Ws....Ws............WsWsWsWsWs....Ws",
        "Ws................WsWs..Ws..Ws..Ws................WsWsWs..............Ws....Ws..............WsWs..............WsWs....$1Ws....Ws",
        "Ws..............................WsWs..............WsWsWs............Ws........Ws..........Ws..WsWsWsWsWs..WsWsWs....WsWs......Ws",
        "Ws................Ws....$1........................Ws....Ws........Ws............Ws......Ws......WsWs....WsWs..Ws..Ws......WsWsWs",
        "Ws................Ws..............Ws......................Ws....Ws..............Ws..WsWs....................Ws............Ws..Ws",
        "Ws................Ws............................Ws..........WsWsWs..............Ws..............WsWs..........Ws........Ws....Ws",
        "WsWsWs..WsWsWsWsWsWsWs............Ws......WsWs..............Ws....................................Ws..........Ws..............Ws",
        "Ws..................WsWs..WsWs..WsWs....WsWs............................$1........Ws............................Ws..Ws........Ws",
        "Ws..................WsWs..................WsWs..............Ws....................Ws..........WsWs............WsWsWs..........Ws",
        "Ws..................Ws....................WsWsWs............WsWsWsWs..............Ws..........Ws..............................Ws",
        "Ws..................Ws....................Ws..WsWs......WsWs........WsWs........Ws....WsWs..Ws................WsWs............Ws",
        "Ws..................Ws....................Ws........WsWs......$1........Ws....Ws....Ws........................Ws..............Ws",
        "WsXX................Ws....................Ws............................WsWsWsWs..............................Ws..............Ws",
        "WsWsWsWsWsWsWsWsWsWsWsWsWsWsWsWsWsWsWsWsWsWsWsWsWsWsWsWsWsWsWsWsWsWsWsWsWsWsWsWsWsWsWsWsWsWsWsWsWsWsWsWsWsWsWsWsWsWsWsWsWsWs..Ws",
        "WsP1..........................................................................................................................Ws",
        "Ws_W_E_L_C_O_M_E  _T_O  _T_H_E  _F_A_N_T_A_S_T_I_C  _W_O_R_L_D  _O_F  _E_M_E_R_A_L_D  _M_I_N_E  _!  _G_O_O_D  _L_U_C_K  _!_!_!Ws",
        "WsWsWsWsWsWsWsWsWsWsWsWsWsWsWsWsWsWsWsWsWsWsWsWsWsWsWsWsWsWsWsWsWsWsWsWsWsWsWsWsWsWsWsWsWsWsWsWsWsWsWsWsWsWsWsWsWsWsWsWsWsWsWsWs"
    ]
}